R 1400 1000
NO ./texture/greystone.xpm
SO ./texture/redbrick.xpm
EA ./texture/wood.xpm
WE ./texture/bluestone.xpm
S ./texture/barrel.xpm
C 255,200,160
F 122,122,122

11111111111111111
10002000200020001
10000000000000001
10202020002020201
10000000S00000001
10002000000200001
10000000000000001
10200000200002001
10000000000000001
11111110001111111
      11011
11111110001111111
10002000200020001
10000000000000001
10202020002020201
10000000000000001
10002000200200001
10000000000000001
10200000200002001
10000000000000001
11111111111111111
